en-English|ru-Russian||
agc|astguiclient.php||
"JAN"|"ЯНВ"||
"FEB"|"ФЕВ"||
"MAR"|"МАР"||
"APR"|"АПР"||
"MAY"|"МАЙ"||
"JUN"|"ИЮН"||
"JLY"|"ИЮЛ"||
"AUG"|"АВГ"||
"SEP"|"СЕН"||
"OCT"|"ОКТ"||
"NOV"|"НОЯ"||
"DEC"|"ДЕК"||
./images/|../agc/images/||
BORDER|Border||
VALUE=SUBMIT|VALUE=SUBMIT||
TYPE=SUBMIT|TYPE=Submit||
MAXLENGTH|maxlength||
English|Английский||
Spanish|Испанский||
French|Французский||
German|Немецкий||
Italian|Итальянский||
agc_check_voicemail_BLINK.gif|agc_check_voicemail_BLINK.gif||
agc_check_voicemail_OFF.gif|agc_check_voicemail_OFF.gif||
agc_check_voicemail_ON.gif|agc_check_voicemail_ON.gif||
agc_live_call_OFF.gif|agc_live_call_OFF.gif||
agc_live_call_ON.gif|agc_live_call_ON.gif||
agc_tab_active_lines.gif|agc_tab_active_lines.gif||
agc_tab_conferences.gif|agc_tab_conferences.gif||
agc_tab_main.gif|agc_tab_main.gif||
vdc_LB_dialnextnumber.gif|vdc_LB_dialnextnumber.gif||
vdc_LB_dialnextnumber_OFF.gif|vdc_LB_dialnextnumber_OFF.gif||
vdc_LB_grabparkedcall.gif|vdc_LB_grabparkedcall.gif||
vdc_LB_hangupcustomer.gif|vdc_LB_hangupcustomer.gif||
vdc_LB_hangupcustomer_OFF.gif|vdc_LB_hangupcustomer_OFF.gif||
vdc_LB_parkcall.gif|vdc_LB_parkcall.gif||
vdc_LB_parkcall_OFF.gif|vdc_LB_parkcall_OFF.gif||
vdc_LB_pause.gif|vdc_LB_pause.gif||
vdc_LB_pause_OFF.gif|vdc_LB_pause_OFF.gif||
vdc_LB_resume.gif|vdc_LB_resume.gif||
vdc_LB_resume_OFF.gif|vdc_LB_resume_OFF.gif||
vdc_LB_startrecording.gif|vdc_LB_startrecording.gif||
vdc_LB_stoprecording.gif|vdc_LB_stoprecording.gif||
vdc_LB_transferconf.gif|vdc_LB_transferconf.gif||
vdc_LB_transferconf_OFF.gif|vdc_LB_transferconf_OFF.gif||
vdc_LB_webform.gif|vdc_LB_webform.gif||
vdc_LB_webform_OFF.gif|vdc_LB_webform_OFF.gif||
vdc_XB_blindtransfer.gif|vdc_XB_blindtransfer.gif||
vdc_XB_blindtransfer_OFF.gif|vdc_XB_blindtransfer_OFF.gif||
vdc_XB_dialwithcustomer.gif|vdc_XB_dialwithcustomer.gif||
vdc_XB_dialwithcustomer_OFF.gif|vdc_XB_dialwithcustomer_OFF.gif||
vdc_XB_hangupbothlines.gif|vdc_XB_hangupbothlines.gif||
vdc_XB_hangupbothlines_OFF.gif|vdc_XB_hangupbothlines_OFF.gif||
vdc_XB_hangupxferline.gif|vdc_XB_hangupxferline.gif||
vdc_XB_hangupxferline_OFF.gif|vdc_XB_hangupxferline_OFF.gif||
vdc_XB_internalcloser.gif|vdc_XB_internalcloser.gif||
vdc_XB_internalcloser_OFF.gif|vdc_XB_internalcloser_OFF.gif||
vdc_XB_leave3waycall.gif|vdc_XB_leave3waycall.gif||
vdc_XB_leave3waycall_OFF.gif|vdc_XB_leave3waycall_OFF.gif||
vdc_XB_localcloser.gif|vdc_XB_localcloser.gif||
vdc_XB_localcloser_OFF.gif|vdc_XB_localcloser_OFF.gif||
vdc_XB_parkcustomerdial.gif|vdc_XB_parkcustomerdial.gif||
vdc_XB_parkcustomerdial_OFF.gif|vdc_XB_parkcustomerdial_OFF.gif||
vdc_XB_hotkeysactive.gif|vdc_XB_hotkeysactive.gif||
vdc_XB_hotkeysactive_OFF.gif|vdc_XB_hotkeysactive_OFF.gif||
vdc_LB_senddtmf.gif|vdc_LB_senddtmf.gif||
vdc_LB_senddtmf_OFF.gif|vdc_LB_senddtmf_OFF.gif||
vdc_XB_header.gif|vdc_XB_header.gif||
vdc_XB_number.gif|vdc_XB_number.gif||
vdc_XB_channel.gif|vdc_XB_channel.gif||
vdc_XB_seconds.gif|vdc_XB_seconds.gif||
vdc_tab_script.gif|vdc_tab_script.gif||
You have now logged out. Thank you|Вы вышли из системы. Спасибо||
astGUIclient web-client VERSION|Версия web-клиента astGUIclient ||
astGUIclient web client|web-клиент astGUIclient||
VICIDIAL web client|web-клиент VICIDIAL||
VICIDIAL web-client version|Версия web-клиента VICIDIAL||
You can only monitor Zap channels|Вы можете только контролировать Zap каналы||
Stop Record|Остановить Запись||
you are logged into this phone|вы зарегистрированы на телефон||
Back to Main Window|Вернуться к Главному Окну||
LIVE CALLS ON THIS PHONE|ЖИВЫЕ ВЫЗОВЫ НА ЭТОТ ТЕЛЕФОН||
LIVE CALLS IN THIS CONFERENCE|ЖИВЫЕ ВЫЗОВЫ В ЭТОЙ КОНФЕРЕНЦИИ||
LIVE CALL TRANSFER|ПЕРЕВОД ЖИВОГО ВЫЗОВА||
CLIENT CHANNEL|КАНАЛ КЛИЕНТА||
REMOTE CHANNEL|УДАЛЕННЫЙ КАНАЛ||
CLICK HERE TO LOG IN AGAIN|КЛИКНИТЕ ЗДЕСЬ, ЧТОБЫ СНОВА ВОЙТИ||
ACTIVE DISPLAY PAUSED|ACTIVE DISPLAY PAUSED||
Main Panel|Главная Панель||
Active Lines Panel|Панель Активных Линий||
Conferences Panel|Панель Конференций||
Check Voicemail|Проверьте Голосовую почту||
Live Call|Живой Вызов||
Hangup Trunk|Hangup Trunk||
Hijack Trunk|Hijack Trunk||
Listen Trunk|Listen Trunk||
Active Local Menu|Активное Локальное Меню||
Hangup Local|Hangup Local||
Hijack Local|Hijack Local||
Listen Local|Listen Local||
Channel to be transferred|Канал в который будет переведен||
Extensions Menu|Меню Расширений||
Send to selected extension|Отправить в выбранное расширение||
Send to selected vmail box|Отправить в выбранный vmail box||
Send to this number|Отправить в этот номер||
click on a number below to send to a conference|кликните на номере ниже, чтобы отправить в конференцию||
Send my channel too|Отправить также мой канал||
Conferences Menu|Меню Конференций||
LOCAL Extensions Dial|ЛОКАЛЬНОЕ Расширение Набора номера||
Phone calling from|Телефонный вызов от||
Call selected extension|Вызов в выбранное расширение||
Call selected vmail box|Вызов в выбранный vmail box||
LOCAL DIAL EXTENSIONS|ЛОКАЛЬНЫЕ РАСШИРЕНИЯ НАБОРА НОМЕРА||
OUTBOUND CALLS|ИСХОДЯЩИЕ ВЫЗОВЫ||
INBOUND CALLS|ВХОДЯЩИЕ ВЫЗОВЫ||
Refresh rate|Норма обновлений||
MANUAL DIAL|РУЧНОЙ НАБОР НОМЕРА||
CALL DATE/TIME|ЗВОНИТЬ ДАТА/ВРЕМЯ||
LOCAL HANGUP|ЛОКАЛЬНВЙ HANGUP||
PARKED CALLS|ПАРКОВАТЬ ВЫЗОВ||
PARKED BY|ПАРКОВАНЫЙ||
PARKED TIME|ВРЕМЯ ПАРКОВКИ||
Registered to|Registered to||
Enter Conference|Вход на Конференцию||
Dial From Conf|Набор номера Conf||
Active Extensions|Активные Расширения||
Outside Lines|Внешние Линии||
Local Extensions|Локальные Расширения||
Data Goes Here|Данные Идут Сюда||
Trunk Action|Trunk Action||
Local Action|Local Action||
Conferences List|Список Конференций||
Click on a conference room number on the left for info on that conference|Для информации о конференции кликните на номер конференции слева||
List Display|Показывать Списки||
Live Extensions|Активные расширения||
Busy Extensions|Занятые Расширения||
script runtime|время выполнения скрипта||
Call Log Display|Показать Логи Вызовов||
is not valid|это неправильно||
or protocol|или протокол||
Conf Extension Check|Conf Extension Check||
has been registered to|был зарегистрирован на||
LIVE INBOUND CALL|ЖИВОЙ ВХОДЯЩИЙ ВЫЗОВ||
Number Dialed|Набранный Номер||
SEND TO MY VOICEMAIL|ПОСЛАТЬ В МОЙ VOICEMAIL||
Live Extension Check|Live Extension Check||
Manager Send|Отослать Менеджеру||
command not inserted|команда не введена||
command sent for|посылать команду для||
One of these variables|Одна из этих переменных||
must be greater than 2 characters|должно быть больше чем 2 символа||
must be greater than 14 characters|должно быть больше чем 14 символов||
must be set|должен быть установлен||
not sent|не послано||
Cannot find empty conference|Не могу найти свободную конференцию||
is not live|это не активно||
RECORDING WILL LAST UP TO 60 MINUTES|ЗАПИСЬ МОЖЕТ ПРОДОЛЖАТЬСЯ ДО 60 МИН.||
Parked Calls Display|Показать Паркованные Вызовы||
Database Query Script|Скрипт Запроса Базы Данных||
Group Choice|Выбор Группы||
has been registered to user|был зарегистрован пользователем||
HOPPER EMPTY|ПУСТОЙ КОНТЕЙНЕР||
LOG NOT ENTERED|LOG НЕ ВВЕДЕН||
has been changed to|был изменен на||
information has been updated|информация обновлена||
is now in status|новый статус||
Voicemail Check|Проверка Voicemail||
voicemail box|voicemail box||
Re-Login|Re-Login||
User Password|Пароль Пользователя||
User Login|Логин Пользователя||
Phone Login|Логин Телефона||
Phone Password|Пароль Телефона||
Campaign not active, please try again|Кампания не активна, пожалуйста, попробуйте еще раз||
Login incorrect, please try again|Логин неправильный, пожалуйста, попробуйте еще раз||
Campaign Login|Логин Кампании||
Sorry, your phone login and password are not active in this system, please try again|Извините, но ваш логин и пароль телефона не активен в этой системе. Пожалуйста, попробуйте еще раз||
leads left to call in hopper|Leads оставил вызовы в контейнере||
CAMPAIGN CUSTOM PARKING|ПОЛЬЗОВАТЕЛЬСКИЙ РЕЖИМ ПАРКОВКИ КАМПАНИИ||
CAMPAIGN DEFAULT PARKING|РЕЖИМ ПАРКОВКИ КАМПАНИИ ПО УМОЛЧАНИЮ||
CAMPAIGN CUSTOM WEB FORM|ПОЛЬЗОВАТЕЛЬСКАЯ WEB-ФОРМА КАМПАНИИ||
CAMPAIGN DEFAULT WEB FORM|WEB-ФОРМА КАМПАНИИ ПО УМОЛЧАНИЮ||
CAMPAIGN ALLOWS CLOSERS|КАМПАНИЯ ПОЗВОЛЯЕТ CLOSERS||
CAMPAIGN ALLOWS NO CLOSERS|КАМПАНИЯ НЕ ПОЗВОЛЯЕТ CLOSERS||
USING PREVIOUS MEETME ROOM|ИСПОЛЬЗОВАНИЕ ПРЕДЫДУЩЕЙ MEETME ROOM||
USING NEW MEETME ROOM|ИСПОЛЬЗОВАНИЕ НОВОЙ MEETME ROOM||
old QUEUE and INCALL reverted list|old QUEUE and INCALL reverted list||
old QUEUE and INCALL reverted hopper|old QUEUE and INCALL reverted hopper||
old vicidial_live_agents records cleared|старые отчеты vicidial_live_agents очищены||
campaign is set to auto_dial_level|кампания установлена в auto_dial_level||
new vicidial_live_agents record inserted|новая vicidial_live_agents запись вставлено||
campaign is set to manual dial|кампания установлена в ручной набор номера||
Sorry, there are no leads in the hopper for this campaign|Жаль, но leads нет в контейнере этой кампании||
Dial Next Number|Набрать следующий номер||
LIVE CALLS IN YOUR SESSION|ЖИВЫЕ ВЫЗОВЫ В ВАШЕЙ СЕССИИ||
Stop Recording|Остановить Запись||
Start Recording|Начать Запись||
Transfer number must have more than 1 digit|У номера перевода должно быть больше чем 1 цифра||
Grab Parked Call|Захват Ожидающего Вызова||
Park Call|Парковать Вызов||
Waiting for Ring|Ожидание Кольца вызова||
Called 3rd party|Вызов третьей стороны||
LEAVE 3-WAY CALL|ОСТАВИТЬ 3-WAY ЗАПРОС||
Dial With Customer|Набор номера С Клиентом||
Park Customer Dial|Парковать Набор номера Клиента||
Hangup Xfer Line|Разъединение Xfer Линии||
Hangup Both Lines|Разъединить Обе Линии||
Hangup Customer|Разъединить Клиента||
Transfer - Conference|Перевод - Конференция||
LOCAL CLOSER|ЛОКАЛЬНЫЙ CLOSER||
INTERNAL CLOSER|ВНУТРЕННИЙ CLOSER||
Dial Blind Transfer|Слепой Перевод Набора номера||
Dial timed out, contact your system administrator|Превышено время ожидания набора номера, свяжитесь с сисадмином||
No more leads in the hopper for campaign|Нет больше leads для кампании в контейнере||
Web Form|Web Форма||
You Must Select a Disposition|Вы Должны Выбрать Диспозицию||
GROUPS NOT SELECTED|ГРУППЫ НЕ ВЫБРАНЫ||
SELECTED GROUPS|ВЫБРАННЫЕ ГРУППЫ||
You cannot log out during a Dial attempt|Вы не можете выйти из системы во время попытки Набора номера||
Wait 50 seconds for the dial to fail out if it is not answered|Ждите 50 секунд набора номера для явного 'нет ответа'||
STILL A LIVE CALL! Hang it up then you can log out|ВСЕ ЕЩЕ АКТИВНЫЙ ЗАПРОС! Разъедините и тогда выходите из системы||
Hide conference call channel information|Скрыть информацию о канале конференц-связи||
Show conference call channel information|Показать информацию о канале конференц-связи||
Logged in as User|Пользователь||
No one is in your session|Никого нет в вашей сессии||
Customer has hung up|Клиент разъединен||
End-of-call Disposition Selection|Выбор Диспозиции End-of-call||
CLOSER INBOUND GROUP SELECTION|ВЫБОР INBOUND ГРУППЫ CLOSER||
BLENDED CALLING|BLENDED CALLING||
outbound activated|исходящие активированы||
Preview the Lead then|Просмотр Lead тогда||
Lead was not reverted, there was an error|Lead не вернулся, была ошибка||
call was not placed, there was an error|вызов не был обслужен, была ошибка||
Number to call|Номер для вызова||
Customer Information|Информация Клиента||
Lead Dispositioned As|Lead Диспозицию как||
Any changes made to the customer information below at this time will not be comitted, You must change customer information before you Hangup the call|Any changes made to the customer information below at this time will not be comitted, You must change customer information before you Hangup the call||
When active, simply press the keyboard key for the desired disposition for this call. The call will then be hungup and dispositioned automatically|Когда активно, просто нажмите клавишу желаемой диспозиции для этого запроса. Тогда запрос будет автоматически разъединен и dispositioned||
Disposition Hot Keys|Горячие Клавиши Диспозиции||
Cust Time|Cust Время||
RECORD ID|ID ЗАПИСИ||
RECORDING FILE|ФАЙЛ ЗАПИСИ||
HOT KEYS ACTIVE|АКТИВНЫЕ ГОРЯЧИЕ КЛАВИШИ||
HOT KEYS INACTIVE|НЕАКТИВНЫЕ ГОРЯЧИЕ КЛАВИШИ||
DIAL OVERRIDE|НАБЕРИТЕ ОТМЕНУ||
SKIP LEAD|ПРОПУСТИТЬ LEAD||
DIAL LEAD|НАБОР LEAD||
LEAD PREVIEW|ПРЕДВАРИТЕЛЬНЫЙ ПРОСМОТР LEAD||
PAUSE AGENT DIALING|ПАУЗА ВЫЗОВА||
DISPOSITION CALL|DISPOSITION CALL||
 session ID| ID сессии||
 to campaign| в кампанию||
Select a CallBack Date|Выберите дату для CallBack||
 maximize| максимизировать||
 minimize| минимизировать||
You must choose a date|Вы должны выбрать дату||
Select a Date Below|Выберите Дату Ниже||
Click on a callback below to call the customer back now. If you click on a record below to call it, it will be removed from the list|Чтобы позвонить клиенту сейчас, кликните на callback ниже. Если Вы нажмете на record ниже, чтобы позвонить, то это будет удалено из списка||
If you want to dial a number and have it NOT be added as a new lead, enter in the exact dialstring that you want to call in the Dial Override field below. To hangup this call you will have to open the CALLS IN THIS SESSION link at the bottom of the screen and hang it up by clicking on its channel link there|Если вы хотите набрать номер, но не добовлять новый lead, введите точный dialstring который вы хотите вызвать в поле Отмены Номера ниже. Для разъединения этого запроса вы должны будете открыть ссылку ЗАПРОСЫ В ЭТОЙ СЕССИИ внизу экрана, at the bottom of the screen and hang it up by clicking on its channel link there||
YOU CANNOT SKIP A CALLBACK OR MANUAL DIAL, YOU MUST DIAL THE LEAD|ВЫ НЕ МОЖЕТЕ ПРОПУСТИТЬ ПОВТОРНЫЙ ЗВОНОК ИЛИ РУЧНОЙ НАБОР НОМЕРА, ВЫ ДОЛЖНЫ DIAL THE LEAD||
YOU MUST BE PAUSED TO MANUAL DIAL A NEW LEAD IN AUTO-DIAL MODE|ВЫ ДОЛЖНЫ СДЕЛАТЬ ПАУЗУ РУЧНОГО НАБОРА НОМЕРА НОВЫЙ LEAD В РЕЖИМЕ АВТО НАБОРА НОМЕРА||
Enter information below for the new lead you wish to call|Ведите информацию ниже для нового lead который вы хотите вызвать||
YOU MUST BE PAUSED TO CHECK CALLBACKS IN AUTO-DIAL MODE|ВЫ ДОЛЖНЫ СДЕЛАТЬ ПАУЗУ, ЧТОБЫ ПРОВЕРИТЬ ВЫЗОВЫ В РЕЖИМЕ АВТОМАТИЧЕСКОГО НАБОРА НОМЕРА||
Note: all new manual dial leads will go into list 999|Примечание: все новые leads ручного набора номера войдут в список 999||
YOU DO NOT HAVE PERMISSIONS TO TRANSFER CALLS|У ВАС НЕТ РАЗРЕШЕНИЯ ДЛЯ ПЕРЕВОДА ВЫЗОВА||
will be added to the beginning of this number|будет добавлен в начале этого номера||
This is usually a 1 in the USA-Canada|Обычно 7 для России и некоторых стран СНГ||
NEW MANUAL DIAL LEAD FOR|НОВЫЙ LEAD РУЧНОЙ НАБОР НОМЕРА ДЛЯ||
Finish and Disposition Call|Конец и Вызов Диспозиции||
10 digits max - digits only|максимально 10 цифр - только цифры||
Note: a dial prefix of|Примечание: префикс набора номера ||
Hangup Again|Разъединить Снова||
Go Back|Вернуться||
Call Agent Again|Вызов Оператора Снова||
MY CALLBACK ONLY|ТОЛЬКО МОИ CALLBACK||
NO ACTIVE CALLBACKS|НЕТ АКТИВНЫХ CALLBACK||
ACTIVE CALLBACKS|АКТИВНЫЕ CALLBACK||
CALLBACKS FOR AGENT|CALLBACK ДЛЯ ОПЕРАТОРА||
Dial Code:|Код страны:||
digits only please|только цифры, пожалуйста||
Dial Now|Новый Набор номера||
CB Comments|CB Комментарии||
Title|Title||
Your Status|Ваш Статус||
 STATUS| СТАТУС||
 RESET| RESET||
CLEAR FORM|ОЧИСТИТЬ ФОРМУ||
SUBMIT|Отправить||
Incoming|Входящий||
Calling|Запрос||
Called|Вызванный||
Campaign|Кампания||
Status|Статус||
Inserted|Введенный||
 seconds| секунды||
HELP|ПОМОЩЬ||
 Login | Логин ||
Login:|Логин:||
User |Пользователь ||
Password|Пароль||
VERSION|ВЕРСИЯ||
BUILD|СБОРКА||
Server|Сервер||
RECORD |ЗАПИСЬ ||
>HANGUP|>РАЗЪЕДИНЕНИЕ||
>XFER|>ПЕРЕВОД||
PARK|ПАРКОВКА||
IN-NUMBER|В-НОМЕР||
NUMBER|НОМЕР||
CALLERID|ВЫЗЫВАЮЩИЙID||
 CALL| ВЫЗОВ||
PICKUP|PICKUP||
CONFERENCE|КОНФЕРЕНЦИЯ||
Refresh|Обновление||
Send DTMF|Послать DTMF||
ORDER|ПОРЯДОК||
 on | на ||
>LOGOUT|>ВЫХОД||
 Channel| Канал||
Extensions|Расширения||
Conferences|Конференции||
Recording|Recording||
Welcome|Добро пожаловать||
VOICEMAIL|Голосовая почта||
 NEW| НОВЫЙ||
 OLD| СТАРЫЙ||
 Pause | Пауза ||
Resume|Резюме||
Faster|Быстрее||
Slower|Медленее||
Initializing|Инициализация||
Invalid|Недопустимо||
Username|Username||
Notes|Примечания||
First|Имя||
MI: |MI: ||
Last|Фамилия||
Address|Адрес||
City|Город||
State|Округ||
PostCode|Индекс||
Province|Область/Край||
Vendor ID|ID Вендора||
DialCode|Код||
Alt. Phone|Альт. Телефон||
Show|Показать||
Email|Email||
Comments|Комментарии||
ALT PHONE DIAL|НАБРАТЬ АЛЬТ. НОМЕР||
MAIN PHONE|ОСНОВНОЙ ТЕЛЕФОН||
ALT PHONE|АЛЬТ. ТЕЛЕФОН||
ADDRESS3|АДРЕСС 3||
FINISH LEAD|ФИНИШ LEAD||
Dial Alt Phone Number|Набор Альт.Номера||
Phone|Телефон||
 DIAL| НАБОР НОМЕРА||
SUBMIT FAVORITES CHANGES - requires logout|ПОДТВЕРДИТЕ ИЗМЕНЕНИЕ ИЗБРАННОГО - требование для выхода из системы||
BACK TO MAIN WINDOW - ignore changes made|ВЕРНУТЬСЯ К ГЛАВНОМУ ОКНУ - игнорирует сделанные изменения||
AVAILABLE EXTENSIONS|ДОСТУПНЫЕ РАСШИРЕНИЯ||
 edit|редактировать||
 FAVORITES|ИЗБРАННОЕ||
Search Existing Leads|Поиск Существующих Leads||
This option if checked will attempt to find the phone number in the system before inserting it as a new lead|Если эта опция выбрана, то будет предпринята попытка найти телефонный номер в системе, прежде чем вставить его как новый lead||
Finish Wrapup and Move On|Финиш Wrapup и Переход||
seconds remaining in wrapup|секунд осталось в wrapup||
Call Wrapup:|Call Wrapup:||
January|Январь||
Frebruary|Февраль||
March|Март||
April|Апрель||
May|Май||
June|Июнь||
July|Июль||
August|Август||
September|Сентябрь||
October|Октябрь||
November|Ноябрь||
December|Декабрь||
Previous Callback Information|Предыдущая Информация о Callback||
Last Call: |Последний Вызов:||
CallBack: |CallBack:||
Agent: |Оператор:||
Comments: |Комментарии:||
VOLUME|ГРОМКОСТЬ||
FAST DIAL|БЫСТРЫЙ НАБОР НОМЕРА||
YOU MUST ENTER A PHONE NUMBER AND DIAL CODE TO USE FAST DIAL|ЧТОБЫ ИСПОЛЬЗОВАТЬ БЫСТРЫЙ НАБОР НОМЕРА, ВЫ ДОЛЖНЫ ВВЕСТИ НОМЕР ТЕЛЕФОНА И КОД СТРАНЫ||
 SELECT A PAUSE CODE :| ВЫБЕРИТЕ КОД ПАУЗЫ :||
ENTER A PAUSE CODE|ВВЕДИТЕ КОД ПАУЗЫ||
YOU MUST BE PAUSED TO ENTER A PAUSE CODE IN AUTO-DIAL MODE|ВЫ ДОЛЖНЫ АКТИВИРОВАТЬ ПАУЗУ, ЧТОБЫ ВВЕСТИ КОД ПАУЗЫ В РЕЖИМЕ АВТО-НАБОРА||
Your session has been disabled|Ваша сессия отключена||
Gender: |Пол:||
Date of Birth: |Дата рождения:||
YOU MUST BE PAUSED TO CHANGE GROUPS|ТЫ ДОЛЖЕН БЫТЬ PAUSED сменить группу||
Calls in Queue:|Звонки в очереди:||
 Timeclock|Timeclock||
The user and password you entered are not active in the system|Пользователя и пароль, которые вы вступили, не действующих в системе||
Please try again|Пожалуйста, повторите попытку||
You cannot log in or out within 30 seconds of your last login or logout|Вы не можете войти или в течение 30 секунд после вашего последнего входа в систему или Logout||
You have now logged-out|Вы уже зарегистрированы отказа||
You logged out at |Вы вошли на||
Amount of time you were logged-in: |Количество раз, когда вы были зарегистрированы в:||
ERROR: timeclock log entry already made: |ОШИБКА: timeclock вход вход уже сделал:||
BACK to Agent Login Screen|BACK TO Агент Логин экрана||
BACK to Administration|BACK TO администрации||
BACK to Welcome Screen|BACK приветствовать экрана||
Time since you were last logged-in: |Время с момента вашего последнего входа в:||
You last logged-out at: |Вы последнего зарегистрированного по адресу:||
Click LOGIN below to log-in|Нажмите кнопку Вход для входа в||
Amount of time you have been logged-in: |Количество раз, когда вы вышли в:||
You logged-in at:|Вы вошли в по адресу:||
Click LOGOUT below to log-out|Нажмите LOGOUT для входа из||
Undefined|Undefined||
This phone number is not in the campaign lists|Этот телефон не находится в списках кампании||
Unspecified error|Неизвестная ошибка||
Extended Alt Phone Information: |Расширенная информация Alt Телефон:||
ALT DIAL NUMBER:|ALT номер:||
Phone Code and Number:|Телефон кодекса и номер:||
Notes: |Примечания:||
Active: |Активно:||
Alt Count: |Alt Кол-во:||
Change this phone number to INACTIVE|Изменить этот телефонный номер НЕАКТИВНОЕ||
Change this phone number to ACTIVE|Изменить этот телефонный номер АКТИВНЫМ||
YOU MUST LOG IN TO THE TIMECLOCK FIRST|Вы должны войти в систему TIMECLOCK ПЕРВЫЙ||
There is a time synchronization problem with your system, please tell your system administrator|Существует проблема синхронизации времени с вашей системой, пожалуйста, сообщите об этом вашему системному администратору||
Preview Call|Предварительный Звоните||
SELECT A GROUP ALIAS|ВЫБОР ГРУППЫ ALIAS||
Group Alias Selection|Группа Alias выбора||
Click Here to Choose a Group Alias|Нажмите здесь, чтобы Выбери группу Alias||
Group Alias|Группа Alias||
ERROR: There are no Shifts enabled for your user group|ОШИБКА: Есть сдвиги не включена для пользователя группы||
ERROR: You are not allowed to log in outside of your shift|ОШИБКА: Вы не можете войти в вашу за переход||
MANAGER OVERRIDE|МЕНЕДЖЕР Переопределить||
Your Shift is over or has changed, you have been logged out of your session|Ваш Shift больше или изменилась, Вы вышли из Вашей сессии||
You are not allowed to dial into other agent sessions|Вы не можете набрать в других сессиях агент||
QUICK TRANSFER|Быстрой передачи||
Other Agents Status|Другие агенты Статус||
Available Agents Transfer|Доступные Агенты передачи||
Show Calls In Queue|Показать Звонки в очередь||
Calls In Queue|Звонки в очередь||
Hide Calls In Queue|Скрыть Звонки в очередь||
Calls in Queue View Disabled for this campaign|Звонки в Очередь Открыть инвалидов для этой кампании||
YOU MUST BE PAUSED TO GRAB CALLS IN QUEUE|ВЫ ДОЛЖНЫ быть приостановлена схватить Звонки в ОЧЕРЕДЬ||
Manager |Менеджер||
has selected your in-group choices|выбрал в вашей группе выбора||
CONSULTATIVE|КОНСУЛЬТАТИВНЫЙ||
Close Message|Закрыть сообщение||
TIMER NOTIFICATION|ТАЙМЕР УВЕДОМЛЕНИЯ||
>AGENTS<|>агенты<||
Inbound|Входящие||
Reports|Отчеты||
Users|Пользователи||
Campaigns|Кампании||
Lists|Лиды||
HOME|Главная||
ADMINISTRATION|Администрирование||
Filters|Фильтры||
Scripts|Скрипты||
Show Scripts|Список скриптов||
Add A New Script|Добавить Скрипт||
Admin|Настройки||
User Groups|Группы||
Chat|Чат||
Remote Agents|Внешние Агенты||
FULL NAME|ИМЯ||
LEVEL|УРОВЕНЬ||
ACTIVE|АКТИВЕН||
GROUP|ГРУППА||
Change language|Сменить язык||
Logout|Выход||
Timeclock|Смены||
Call Times|Время вызовов||
Shifts|Смены||
Phones|Телефоны||
Templates|Шаблоны||
Carriers|Транки||
Servers|Серверы||
System Settings|Системные настройки||
Screen Labels|Экранные подписи||
Screen Colors|Цвета оформления||
System Statuses|Системные статусы||
Status Groups|Группы статусов||
Groups|Группы||
Audio Store|Хранение аудио||
Music On Hold|Музыка при удержании||
Languages|Переводы||
Message Groups|Группы сообщений||
Settings Containers|Контейнер настроек||
Show Languages|Список переводов||
Add A New Language|Добавить перевод||
Copy A Languages Entry|Скопировать перевод||
Import Phrases|Импорт фраз||
Export Phrases|Экспорт фраз||
PHRASES SUBMITTED|ФРАЗ ОТПРАВЛЕНО||
PHRASES ADDED|ФРАЗ ДОБАВЛЕНО||
PHRASES UPDATED|ФРАЗ ОБНОВЛЕНО||
MODIFY A LANGUAGE RECORD|ИЗМЕНЕНИЕ ПЕРЕВОДА||
LANGUAGE ID|ID ПЕРЕВОДА||
Description|Описание||
Code|Код||
ACT|Активен||
ADMIN GROUP|Группа||
MODIFY DATE|Время изменения||
PHRASES|ФРАЗ||
MODIFY|Правка||
LOAD|Нагрузка||
CHAN|Каналы||
AGNT|Агенты||
DISK|Диск||
OUTBOUND|Исходящие||
Admin Utilities|Утилиты администратора||
Server Stats and Reports|Серверная статистика и отчеты||
System Summary|Отчет по системе||
Real-Time Reports|Онлайн отчеты||
Agent Reports|Отчёты по агентам||
Inbound and Outbound Calling Reports|Отчеты по исходящим и входящим вызовам||
Other Reports and Links|Другие отчеты и ссылки||
Time Clock Reports|Отчет по сменам||
Enable Languages|Разрешить перевод||
YES|ДА||
LINK|Ссылка||
Show Users|Список Агентов||
Add A New User|Добавить Агента||
Copy User|Скопировать Агента||
Search For A User|Искать Агента||
User Stats|Статистика||
User Status|Статус||
Time Sheet|Табель||
STATS|Статистика||
USER LISTINGS|СПИСОК АГЕНТОВ||
show all users|отобразить всех агентов||
Inbound Groups|Входящие группы||
Show In-Groups|Отобразить входящие||
Add A New In-Group|Добавить группу||
Copy In-Group|Скопировать группу||
Inbound DIDs|Входящие DID||
Show DIDs|Список DID||
Add A New DID|Добавить DID||
Copy DID|Скопировать DID||
Call Menus|Голосовые меню (IVR)||
Show Call Menus|Список меню||
Add A New Call Menu|Добавить меню||
Copy Call Menu|Скопировать меню||
Filter Phone Groups|Фильтр-группы по номеру||
Add Filter Phone Group|Добавить фильтр-группу||
Add-Delete FPG Number|Добавление/удаление номера||
Show Campaigns|Список кампаний||
Add A New Campaign|Добавить кампанию||
Copy Campaign|Скопировать кампанию||
Real-Time Campaigns Summary|Онлайн отчет кампании||
USER GROUPS LISTINGS|СПИСОК ГРУПП АГЕНТОВ||
USER GROUP|ГРУППА АГЕНТОВ||
GROUP NAME|ИМЯ ГРУППЫ||
FORCE TIMECLOCK|ПРИНУДИТЕЛЬНЫЙ УЧЕТ||
NO|НЕТ||
Show User Groups|Список групп агентов||
Add A New User Group|Добавить группу агентов||
Group Hourly Report|Почасовой отчёт||
Bulk Group Change|Массовые изменения||
LEAD FILTER LISTINGS|СПИСОК ФИЛЬТРОВ ЛИДОВ||
FILTER ID|ID ФИЛЬТРА||
FILTER NAME|ИМЯ ФИЛЬТРА||
COLOR|ЦВЕТ||
SCRIPTS LISTINGS|СПИСОК СКРИПТОВ||
SCRIPT ID|ID СКРИПТА||
SCRIPT NAME|ИМЯ СКРИПТА||
Script Text|Текст скрипта||
no spaces or punctuation|без пробелов и пунктуации||
title of the script|заголосов скрипта||
Script Comments|Комментарий||
Show Lists|Списки лидов||
Add A New List|Добавить список||
Search For A Lead|Искать Лид||
Add A New Lead|Добавить Лид||
Add-Delete DNC Number|Обновление ЧС||
Load New Leads|Загрузить Лиды||
LIST LISTINGS|СПИСКИ ЛИДОВ||
show list leads counts|отобразить количество лидов||
LIST ID|ID СПИСКА||
LIST NAME|ИМЯ СПИСКА||
RTIME|СБРОС||
LEADS COUNT|КОЛ-ВО ЛИДОВ||
CALL TIME|ВРЕМЯ ВЫЗОВА||
LAST CALL DATE|ПОСЛЕДНИЙ ВЫЗОВ||
CAMPAIGN LISTINGS|СПИСК КАМПАНИЙ||
show only active campaigns|отобразить только активные||
CAMPAIGN ID|ID КАМПАНИИ||
NAME|ИМЯ||
DIAL METHOD|МЕТОД НАБОРА||
LEAD ORDER|ПОРЯДОК ВЫБОРА||
DIAL STATUSES|СТАТУСЫ||
Agent Screen Labels|Подписи Экрана Агента||
CID GROUP LISTINGS|СПИСОК CID ГРУПП||
TYPE|ТИП||
CID GROUP ID|ID CID ГРУППЫ||
CIDS|ЧИСЛО||
CID Groups|CID Группы||
Add A CID Group|Добавить CID группу||
hide list leads counts|скрыть число лидов||
Monday|Понедельник||
LINKS|ССЫЛКИ||
SERVER ID|ID СЕРВЕРА||
AGENT|АГЕНТ||
TRUNKS|ТРАНКИ||
SERVER IP|IP СЕРВЕРА||
Show Servers|Список серверов||
Add A New Server|Добавить сервер||
CONFERENCE LISTINGS|СПИСОК КОНФЕРЕНЦИЙ||
Add A Screen Label|Добавить подпись||
LABEL ID|ID ПОДПИСИ||
DID Extension|Номер DID||
DID Description|Описание DID||
Admin User Group|Группа администраторов||
no spaces or dashes|без пробелов или тире||
Source DID|Исходный DID||
CALL MENU LISTINGS|СПИСОК ГОЛОСОВЫХ МЕНЮ||
MENU ID|ID Меню||
PROMPT|Приветствие||
TIMEOUT|Таймаут||
OPTIONS|Опции||
Menu Name|Имя меню||
Menu Prompt|Голосовое приветствие||
Menu Timeout|Таймаут||
Menu Timeout Prompt|Сообщение при таймауте||
Menu Invalid Prompt|Сообщение при неверном выборе||
Menu Repeat|Повторов меню||
Menu Time Check|Проверка времени||
Track Calls in Real-Time Report|Отслеживать вызовы в отчёте||
Tracking Group|Группа трекинга||
Log Key Press|Логировать выбор||
Log Field|Поле для логирования||
MODIFY A CALL MENU RECORD|ПРАВКА ГОЛОСОВОГО МЕНЮ||
Holidays defined for this call time|Выходных в интервале времени||
audio chooser|выбор аудио||
Route|Маршрут||
Audio File|Аудио файл||
copy|копия||
Option|Опция||
No DTMF Logging|Без логирования DTMF||
Realtime Tracking|Отслеживание realtime||
No Time Check|Без проверки времени||
DTMF Logging Enabled|Логирование DTMF||
No Realtime Tracking|Без отслеживания||
Time Check|Проверка времени||
Show Call Times|Список интервалов||
Add A New Call Time|Добавить интервал||
Show State Call Times|Интервалы по регионам||
Add A New State Call Time|Добавить региоанальный интервал||
Holidays|Выходные||
Add Holiday|Добавить выходной||
Total Stats for Yesterday|Общая статистика за вчера||
view max stats|развернутая статистика||
Total Stats for Today|Общая статистика за сегодня||
Total Calls|Всего вызовов||
Total Inbound Calls|Всего входящих||
Total Outbound Calls|Всего исходящих||
Maximum Agents|Саксимум агентов||
Inactive|Неактивных||
Total|Всего||
Records|Записи||
In-Groups|Входящие||
DIDs|Номера||
Agents Logged In|Агентов онлайн||
Agents In Calls|Агентов в вызовах||
Active Calls|Активных вызовов||
Calls Ringing|В прогрессе||
runtime|время выполнения||
seconds|секунд||
delete phrase|удалить фразу||
Add A New Language Phrase|Добавить новый перевод||
RELOAD PAGE|ОБНОВИТЬ||
Click here to see Admin changes to this Language entry|Отобразить историю правок в перевод||
DELETE LANGUAGE ENTRY|УДАЛИТЬ ПЕРЕВОД||
Not Translated|Не переведено||
display all|отобразить все||
not translated only|только без перевода||
translated only|только переведённые||
edit|править||
Last Modified|Последнее изменение||
Language Code|Код языка||
Language Description|Описание языка||
Import Action|Действие при импорте||
Import Data|Данные для импорта||
Campaign Name|Имя кампании||
Campaign Description|Описание||
Campaign Change Date|Время изменения||
Campaign Login Date|Время входа||
Park Music-on-Hold|Музыка при парковке||
Default Transfer Group|Группа для переадресации||
Allow Inbound and Blended|Разрешить входящие и смешанные||
List Order|Порядок выборки||
Minimum Hopper Level|Минимальный размер буфера||
Get Call Launch|Действие при старте вызова||
DELETE THIS CAMPAIGN|УДАЛИТЬ КАМПАНИЮ||
LOG ALL AGENTS OUT OF THIS CAMPAIGN|РАЗЛОГИНИТЬ ВСЕХ АГЕНТОВ ИЗ КАМПАНИИ||
Click here to see Admin changes to this campaign|Просмотр лога изменений кампании||
Click here to see what leads are in the hopper right now|Просмотр текущего буфера набора||
no active lists selected for this campaign|нет активных списков лидов в кампании||
HIDE|СКРЫТЬ||
Statuses|Статусы||
HotKeys|Клавиши||
Pause Codes|Коды пауз||
PRIORITY|Приоритет||
INBOUND GROUP LISTINGS|СПИСОК ВХОДЯЩИХ ГРУПП||
TIME|Время||
Web Form Two|Вторая Web Форма||
SELECTED|Выбор||
RANK|Ранг||
GRADE|Класс||
CALLS TODAY|Вызовов сегодня||
DIDS USING THIS IN-GROUP|НОМЕРА ИСПОЛЬЗУЮЩИЕ ГРУППУ||
CALL MENUS USING THIS IN-GROUP|МЕНЮ ИСПОЛЬЗУЮЩИЕ ГРУППУ||
CAMPAIGNS ALLOWING THIS IN-GROUP|КАМПАНИИ С ПОДКЛЮЧЕНИЕМ ГРУППЫ||
DELETE THIS IN-GROUP|УДАЛИТЬ ВХОДЯЩУЮ ГРУППУ||
Click here to see Admin changes to this In-Group|Просмотр лога изменений входящей группы||
Group ID|ID группы||
Group Color|Цвет группы||
moh chooser|выбор музыки||
CARRIER|Транк||
Record Call|Запись вызова||
DID Carrier Description|Описание транка||
CUSTOM CAMPAIGN STATUSES LISTINGS|ИНДИВИДУАЛЬНЫЕ СТАТУСЫ КАМПАНИЙ||
MODIFY STATUSES|ПРАВКА СТАТУСОВ||
Basic|Основные||
Detail|Детально||
CUSTOM STATUSES WITHIN THIS CAMPAIGN|ИНДИВИДУАЛЬНЫЕ СТАТУСЫ ДАННОЙ КАМПАНИИ||
Selectable|Вибираемый||
Human Answer|Ответ человека||
Completed|Завершён||
Answering Machine|Автоответчик||
DELETE|Удалить||
CATEGORY|Категория||
Survey|Опрос||
Real-Time Main Report|Основной онлайн отчёт||
Inbound Report|Отчет по входящим||
Inbound Report by DID|Отчет по входящим DID||
Inbound Daily Report|Отчёт по входящим по дням||
Real-Time Campaign Summary|Онлайн статистика по исходящим||
Inbound IVR Report|Отчет по входящим IVR||
Date Range|Диапазон дат||
to|по||
Search archived data|искать в архиве||
DOWNLOAD|Скачать||
Shift|Смена||
SVN Version|SVN версия||
DB Schema Version|Версия схемы БД||
DB Schema Update Date|Дата обновления версии БД||
MODIFY SYSTEM SETTINGS|ПРАВКА СИСТЕМНЫХ НАСТРОЕК||
PHONE LISTINGS|СПИСОК ТЕЛЕФОНОВ||
Template Name|Имя шаблона||
Show Templates|Список шаблонов||
Add A New Template|Добавить новый шаблон||
DELETE THIS CONF TEMPLATE|УДАЛИТЬ ШАБЛОН КОНФИГУРАЦИИ||
Select Campaigns|Выбор кампании||
Close Panel|Закрыть панель||
Screen Refresh Rate|Частота обновления||
Monitor|Прослушивание||
To select more than 1 campaign, hold down the Ctrl key and click|Для выбора более 1 кампании зажмите Ctrl||
Select User Groups|Группы пользователей||
Select In-Groups|Входящие проекты||
Inbound SLA Stats|Входящий SLA||
Show Carrier Stats|Статистика транков||
Agent Time Stats|Статистика агентов||
Parked Call Stats|Отчёт по парковке||
Display as|Формат отображения||
IMPORT LANGUAGE PHRASES|Импорт фраз перевода||
Only Add Missing Phrases|Только добавлять фразы||
Only Update Existing Phrases|Только обновить существующие фразы||
Add and Update Phrases|Добавить и обновить фразы||
Strength|Сложность||
Length|Длина||
Last Login Info|Последний вход||
User Number|Логин агента||
AGENT INTERFACE OPTIONS|Настройки интерфейса агента||
DELETE THIS USER|УДАЛИТЬ ПОЛЬЗОВАТЕЛЯ||
Click here for user status|Нажмите для информации о статусе||
Click here for user stats|Нажмите для информации о статистике||
Click here for user multiple day status detail report|Нажмите для отчета о статусе за несколько дней||
Click here for user CallBack Holds|Нажмите для информации о запланированных обратных вызовах||
Click here to see Admin changes to this record|Нажмите для информации о изменениях||
RESULTS|Записей||
Lead search|Поиск лида||
LAST AGENT|Агент||
LAST CALL|Время вызова||
IVR LOGS FOR THIS LEAD|ЛОГИ IVR ПО КОНТАКТУ||
CALLS TO THIS LEAD|ВЫЗОВЫ ПО КОНТАКТУ||
ADD NEW CALL TIME|ДОБАВИТЬ НОВЫЙ ИНТЕРВАЛ ВЫЗОВОВ||
Call Time ID|ID интервала||
Call Time Name|Имя интервала||
Call Time Comments|Описание интервала||
Day and time options will appear once you have created the Call Time Definition|Настроки времени и дня недели доступны после создания записи интервала||
short description of the call time|короткое описание интервала времени||
digits only|только цифры||
List Description|Описание списка||
Load leads from this file|Загрузка из файла||
List ID Override|ID списка контактов||
Phone Code Override|Код страны||
File layout to use|Настройки полей||
Standard Format|Стандартный формат||
Custom layout|Собственный шаблон||
Custom Template|Настроенный формат||
override template setting|переопределить настройки шаблона||
View template info|Просмотр шаблона||
Custom Layout to Use|Шаблон полей||
Lead Duplicate Check|Проверка дублей||
Status Duplicate Check|Проверка статуса дублей||
USA-Canada Check|USA/Canada проверка||
Lead Time Zone Lookup|Поиск часового пояса||
State Abbreviation Lookup|Поиск штата||
Required Phone Number Length|Требуеа длинна номера||
BACK TO ADMIN|ВЕРНУТЬСЯ К АДМИНИСТРИРОВАНИЮ||
Show Email Groups|Список Email групп||
Add New Email Group|Добавить Email группу||
Copy Email Group|Копировать Email группу||
LIST ADDED|Список добавлен||
MODIFY A LISTS RECORD|Изменение списка||
TIME ZONES WITHIN THIS LIST|Часовые пояса в списке||
CLEAR THIS LIST|ОТЧИСТИТЬ ЭТОТ СПИСОК||
DELETE THIS LIST|УДАЛИТЬ ЭТОТ СПИСОК||
List Change Date|Последнее изменение списка||
List Last Call Date|Последний вызов по списку||
Resets Today|Сбросов сегодня||
Expiration Date|Дата просрочки||
New List Addition|Добавление нового списка||
LIST MODIFIED|Список изменён||
Modify List|Изменение списка контактов||
voicemail chooser|выбор голосовой почты||
Click here to see Admin changes to this list|Просмотр изменений администраторами в списке||
Click here to see all CallBack Holds in this list|Просмотр всех обратных вызовов в списке||
Click here to download this list|Нажмите для скачивания списка||
GROUP MODIFIED|Группа изменена||
MODIFY A GROUPS RECORD|Редактирование группы входящих||
AGENT RANKS FOR THIS INBOUND GROUP|Умения агентов по данной группе входящих||
select all|выбрать все||
Call Menu Options|Опции меню||
CALL MENU MODIFIED|Голосовое меню изменено||
Phone Code|Код страны||
Custom Dialplan Entry|Дополнение диалплана||
DELETE THIS CALL MENU|УДАЛИТЬ ДАННОЕ МЕНЮ||
REMOTE AGENTS LISTINGS|СПИСОК ВИРТУАЛЬНЫХ АГЕНТОВ||
Show Remote Agents|Список вирт.агентов||
Add New Remote Agents|Добавить вирт.агентов||
Show Extension Groups|Список групп номеров||
Add Extension Group|Добавить группу номеров||
Add A New Email Group|Добавить Email группу||
Template ID|ID шаблона||
MODIFY A CONF TEMPLATE RECORD|ПРАВКА ШАБЛОНА SIP КОНФИГУРАЦИИ||
Template Contents|Содержимое шаблона||
PHONES USING THIS CONF TEMPLATE|Телефоны использующие шаблон||
CARRIERS USING THIS CONF TEMPLATE|Транки использующие шаблон||
Click here to see Admin changes to this conf template|Просмотр изменений в данном шаблоне||
EXTENSION|Внутренний номер||
CONF TEMPLATE MODIFIED|ШАБЛОН ИЗМЕНЁН||
Click here to delete conf template|Нажмите здесь для подтверждения удаления шалона||
CONF TEMPLATE DELETION CONFIRMATION|ПОДТВЕРЖДЕНИЕ УДАЛЕНИЯ ШАБЛОНА||
CONF TEMPLATE DELETION COMPLETED|УДАЛЕНИЕ ШАБЛОНА ВЫПОЛНЕНО||
CONF TEMPLATE LISTINGS|СПИСОК ШАБЛОНОВ||
--ALL--|--ВСЕ--||
NEW SEARCH|НОВЫЙ ПОИСК||
Address1|Адрес1||
Address2|Адрес2||
Timezone|Часовой пояс||
DATE/TIME|Дата/Время||
WAIT|Ожидание||
TALK|Разговор||
ACTION|Действие||
CALL MENU|Меню||
OUTBOUND EMAILS FOR THIS LEAD|Исходящие Email по контакту||
PARK LOGS FOR THIS LEAD|Детализация парковки по контакту||
Agent chatting|Оператор в чате||
Agent waiting for call|Оператор ожидает вызов||
Agent on call|Оператор в вызове||
Agent Paused|Оператор на паузе||
Agent in 3-WAY|Оператор в конференции||
Agent on a dead call|Интерфейс оператора неактивен||
Choose Report Display Options|Настроить опции отображение ||
calls waiting for agents|ожидающие вызовы||
agents waiting|агентов ожидает||
current active calls|активные вызовы||
calls in IVR|вызовы в IVR||
agents in dispo|агенты в поствызове||
agents in dead calls|агенты неактивны||
paused agents|агенты в паузе||
RELOAD NOW|ОБНОВИТЬ||
SUMMARY|Сводка||
LEADS IN HOPPER|БУФЕР КОНТАКТОВ||
CALL TYPE|Тип вызова||
STATION|Место||
PAUSE|Пауза||
CALLS|Вызовов||
System Load Average|Загрузка системы||
agents logged in on all servers|агентов вошло на всех серверах||
Calls Waiting|Ожидающие вызовы||
minute|минута||
minutes|минут||
DIAL LEVEL|Уровень набора||
DROPPED|Пропущено||
ANSWERED|Отвечено||
Agents Time On Calls Campaign|Агенты в кампании||
PHONE NUMBER|Номер телефона||
ALL CAMPAIGNS|ВСЕ КАМПАНИИ||
Dates|Даты||
ALL USER GROUPS|ВСЕ ГРУППЫ||
ALL USERS|ВСЕ АГЕНТЫ||
Time range|Интервал времени||
TOTALS|СУММА||
AGENTS|АГЕНТОВ||
Statistics related to handling of calls only|Статистика только по обработке вызовов||
Show date breakdown|Разбить по датам||
Time in seconds|Время в секундах||
Country|Страна||
information modified|изменения произведены||
Close This Window|Закрыть это окно||
Go back to the lead modification page|Вернуться на страницу изменения контакта||
STATUS NAME|Имя статуса||
NOT CALLED|Не набрано||
Agent Performance Detail|Детализация производительности операторов||
Team Performance Detail|Детализация производительности групп||
Server Performance Report|Производительность серверов||
NO LIVE CALLS WAITING|НЕТ ОЖИДАЮЩИХ ВЫЗОВОВ||
Selected In-Groups|Выбранные входящие проекты||
Change, Add, Remove|Правка/Добавление/Удаление||
Blended Outbound Autodial|Смешанный автонабор||
Set As User Default|Установить по-умолчанию||
Submit Changes|Внести изменения||
DIALABLE LEADS|Лидов к набору||
VIEW LESS|Меньше||
VIEW MORE|Больше||
Agent in email|Оператор в обработке email||
HIDE WAITING CALLS|Скрыть ожидающие вызовы||
SHOW WAITING CALLS|Отобр. ожидающие вызовы||
SHOW SERVER INFO|Отобр. сервер||
HIDE SERVER INFO|Скрыть сервер||
SHOW PHONES|Отобр. р.место||
HIDE PHONES|Скрыть р.место||
Close Alert|Скрыть предупреждение||
Campaigns with no dialable leads|Кампании без лидов к набору:||
VIEW USER GROUP|Отобр. группу агента||
HIDE USER GROUP|Скрыть группу агента||
SHOW IN-GROUP STATS|Отобр. статистику входящих||
HIDE IN-GROUP STATS|Скрыть статистику входящих||
SHOW CUSTPHONES|Отобр. телефон||
HIDE CUSTPHONES|Скрыть телефон||
SHOW CUST INFO|Отобр. информацию клиента||
HIDE CUST INFO|Скрыть информацию клиента||
Dialable Leads Alert|Проверка доступных лидов||
PLEASE SELECT A CAMPAIGN AND DATE-TIME ABOVE AND CLICK SUBMIT|ПОЖАЛУЙСТА ВЫБЕРИТЕ КАМПАНИЮ И ДАТУ ВЫШЕ  ||
NOTE: stats taken from shift specified|Примечание: статистика предоставляется по выбранной смене||
Only live agents|Только онлайн агенты||
Show defunct users|С удаленными агентами||
Show %s|Показ. %||
CALL STATS BREAKDOWN|РАСПРЕДЕЛЕНИЕ ВЫЗОВНОЙ АКТИВНОСТИ||
PAUSE CODE BREAKDOWN|ПО КОДУ ПАУЗЫ||
ALL PHRASES|ВСЕ ФРАЗЫ||
USER NAME|ПОЛЬЗОВАТЕЛЬ||
SYSTEM STATUS MODIFIED|Системный статус изменён||
STATUSES WITHIN THIS SYSTEM|Статусы в системе||
MODIFY/DELETE|Правка/Удаление||
ADD NEW SYSTEM STATUS|Добавить новый системный статус||
ADD|Добавить||
Sale|Сделка||
Status Categories|Категории статусов||
QC Status Codes|QC коды||
Add A Status Group|Добавить группу статусов||
STATUS GROUP LISTINGS|Список групп статусов||
STATUS GROUP ID|ID групп статусов||
TMA|SLA||
Average Hold time for Answered Calls|Ср.удержание для отвеченных||
Average Hold time for Dropped Calls|Ср.удержание для сброшенных||
Average Hold time for All Calls|Ср.удержание для всех вызовов||
DROPS TODAY|СБРОШЕНО сегодня||
ANSWERS TODAY|ОТВЕЧЕНО сегодня||
DROP PERCENT|LCR||
NO AGENTS ON CALLS|НЕТ ОПЕРАТОРОВ ||
HOLD|Удержание||
IN-GROUP|Входящий проект||
MM:SS|ММ:СС||
DIALTIME|Ожидание||
SESSIONID|Сессия||
Close|Закрыть||
callback queue calls|запланировано обратных вызовов||
uploaded size|размер загрузки||
Audio File to Upload|Аудио файл для загрузки||
All spaces will be stripped from uploaded audio file names|Все пробелы будут удалены из имён файлов||
audio file list|список аудио файлов||
File to Copy|Файл для копирования||
Original file|исходный файл||
New file|Новый файл||
File to Delete|Файл для удаления||
select file|выбрать файл||
Click here to see a log of the uploads to the audio store|Нажмите для получения лога загрузки в хранилище аудио||
LANGUAGE LISTINGS|СПИСОК ПЕРЕВОДОВ||
REMOVING LIST HOPPER LEADS FROM OLD CAMPAIGN HOPPER|УДАЛЕНИЕ КОНТАКТОВ ИЗ БУФЕРА КАМПАНИИ||
REMOVING LEADS FROM LIST TABLE|УДАЛЕНИЕ КОНТАКТОВ ИЗ СПИСКА||
LIST CLEARING COMPLETED|ОТЧИСТКА СПИСКА ЗАВЕРШЕНА||
LIST CLEAR CONFIRMATION|ПОДТВЕРЖДЕНИЕ ОТЧИСТКИ СПИСКА||
Click here to clear list and all of its leads|Нажмите для отчистки списка и удаления всех лидов||
LEAD RECYCLING WITHIN THIS CAMPAIGN|ПОВТОРНЫЕ ВЫЗОВЫ В КАМПАНИИ||
ATTEMPT DELAY|Задержка||
ATTEMPT MAXIMUM|Число попыток||
LEADS AT LIMIT|Стоп||
ADD NEW CAMPAIGN LEAD RECYCLE|Добавить новое правило повторных вызовов||
Lead counts taken from active lists in the campaign only|Количество контактов получено изактивных листов кампании||
COPY A PHONE|КОПИРОВАНИЕ ТЕЛЕФОНА||
PHONE COPIED|ТЕЛЕФОН СКОПИРОВАН||
VIEW HERE|ПРОСМОТР||
Please allow up to 1 minute for the server dialplan to update with the new phone|Подождите 1 минуту для обновление плпн набора с учетом нового телефона||
NOTE: Copying a phone will copy all the settings from the selected source phone, except for the settings entered above.|ПРИМЕЧАНИЕ: При копировании переносятся все настройки телефона, исключая поля перечисленные выше||
Registration Password|SIP пароль||
Login Password|Пароль логина||
REMOVING LIST LEADS FROM LIST TABLE|УДАЛЕНИЕ ЛИДОВ ИЗ ТАБЛИЦЫ СПИСКОВ||
LIST DELETION COMPLETED|УДАЛЕНИЕ СПИСКА ЗАВЕРШЕНО||
Source Campaign|Исходная кампания||
COPY A CAMPAIGN|СКОПИРОВАТЬ КАМПАНИЮ||
NOTE: Copying a campaign will copy all settings from the master campaign you select, but it will not copy a campaign-specific DNC list if there was one on the selected master campaign.|ПРИМЕЧАНИЕ: Копирование кампании переносит все настройки из выбранной исходной кампании, но не копирует DNC списки если они заданны для копируемой кампании.||
Click here to delete campaign|Нажмите для удаления кампании||
CAMPAIGN DELETION COMPLETED|УДАЛЕНИЕ КАМПАНИИ ЗАВЕРШЕНО||
Holiday Rule Added|Выходной добавлен||
MODIFY A CALL TIME|ПАВКА ИНТЕРВАЛА ВРЕМЕНИ||
DELETE THIS CALL TIME DEFINITION|УДАЛИТЬ ЭТО ВРЕМЕННОЕ ПРАВИЛО||
Click here to see Admin changes to this call time|Нажмите для просмотра правок временного правила||
CAMPAIGNS USING THIS CALL TIME|КАМПАНИИ ИСПОЛЬЗУЮЩИЕ ИНТЕРВАЛ||
INBOUND GROUPS USING THIS CALL TIME|ВХОДЯЩИЕ ПРОЕКТЫ ИСПОЛЬЗУЮЩИЕ ИНТЕРВАЛ||
CALL MENUS USING THIS CALL TIME|МЕНЮ ИСПОЛЬЗУЮЩИЕ ИНТЕРВАЛ||
LISTS SET TO THIS CALL TIME|СПИСКИ КОНТАКТОВ ИСПОЛЬЗУЮЩИЕ ИНТЕРВАЛ||
Sunday Start|Воскресенье от||
Sunday Stop|Воскресенье до||
Monday Start|Понедельник от||
Monday Stop|Понедельник до||
Tuesday Start|Вторник от||
Tuesday Stop|Вторник до||
Wednesday Start|Среда от||
Wednesday Stop|Среда до||
Thursday Start|Четверг от||
Thursday Stop|Четверг до||
Friday Start|Пятница от||
Friday Stop|Пятница до||
Saturday Start|Суббота от||
Saturday Stop|Суббота до||
Contacts|Контакты||
Add A Contact|Добавить контакт||
Office Number|Офис||
BU Name|Подразделение||
Department|Отдел||
Job Title|Должность||
Location|Расположение||
ADD NEW CONTACT|ДОБАВИТЬ НОВЫЙ КОНТАКТ||
First Name|Имя||
Last Name|Фамилия||
Cell Number|Мобильный||
Other Number 1|Др.номер 1||
Other Number 2|Др.номер 2||
HOLIDAY LISTINGS|Список праздников||
HOLIDAY ID|ID праздника||
DATE|Дата||
START|Начало||
STOP|Конец||
DELETE THIS HOLIDAY DEFINITION|Удалить запись о выходном дне||
Click here to see Admin changes to this holiday|Нажмите для просмотра правок в выходной||
STATE CALL TIMES USING THIS HOLIDAY|Региональные интервалы использующие выходной||
CALL TIMES USING THIS HOLIDAY|Время вызова использующие выходной||
MODIFY A HOLIDAY|Правка выходного дня||
Holiday Name|Имя выходного||
short description of the holiday|короткое описание дня||
Holiday Comments|Комментарий||
Default Start|Время от||
Default Stop|Время до||
Holiday Date|Дата выходного||
Holiday Status|Статус||
HOLIDAY MODIFIED|ВЫХОДНОЙ ИЗМЕНЕН||
CALL MENU ADDED|ГОЛОСОВОЕ МЕНЮ ДОБАВЛЕНО||
HOLIDAY DELETION CONFIRMATION|ПОДТВЕРЖДЕНИЕ УДАЛЕНИЯ ВЫХОДНОГО||
Click here to delete holiday|Нажмите для удаление выходного дня||
EXPIRED|Просрочен||
Day and time options will appear once you have created the Holiday Definition|Настройки времени доступны после создания записи о выходном||
HOLIDAY ADDED|ВЫХОДНОЙ ДОБАВЛЕН||
Holiday Rule Removed|Запись о выходном удалена||
HOLIDAY DELETION COMPLETED|УДАЛЕНИЕ ВЫХОДНОГО ВЫПОЛНЕНО||
CALL TIME DELETION CONFIRMATION|ПОДТВЕРЖДЕНИЕ УДАЛЕНИЯ ИНТЕРВАЛА ВРЕМЕНИ||
Click here to delete call time|Нажмите для удаления интервала времени||
show all lists|отобразить все списки||
hide inactive lists|скрыть неактивные списки||
EXPORT LANGUAGE PHRASES|ЭКСПОРТ ПЕРЕВОДА||
Export Action|Действие при экспорте||
Only NOT Translated Phrases|Только БЕЗ перевода||
Only Translated Phrases|Только с переводом||
save|сохранить||
reset|сброс||
SOUNDBOARD ENTRY ADDED|ЗАПИСЬ SOUNDBOARD ДОБАВЛЕНА||
Show Soundboard Entries|Показать Soundboard||
Add A New Soundboard Entry|Добавить новый Soundboard||
Copy A Soundboard Entry|Скопировать Soundboard||
Audio Files|Аудио файлы||
Sample Soundboard View|Предпросмотр Soundboard||
Add An Audio File|Добавление аудио файла||
MODIFY A USERS RECORD|ИЗМЕНЕНИЕ ПОЛЬЗОВАТЕЛЯ||
USER MODIFIED|ПОЛЬЗОВАТЕЛЬ ИЗМЕНЁН||
template builder|настройка шаблонов||
Go to Lead Loader|К загрузке лидов||
Select template to edit/delete|Выберите шаблон для правки/удаления||
Edit / delete an existing template|Изменить/удалить шаблон||
Create a new template|Создать новый шаблон||
Listloader Custom Template Maker|Создание шаблонов загрузки лидов||
Sample file fitting template|Пример файла в соответствии с шаблоном||
needed for field assignation|нужен для назначения полей||
Load From Lead File|Загрузить из файла||
CAMPAIGN AGENT PAUSE CODE LISTINGS|Список кодов пауз кампании||
MODIFY PAUSE CODES|Правка кодов паузы||
Pause Code|Код паузы||
ADD NEW AGENT PAUSE CODE|Добавить новый код паузы||
Billable|Оплачиваемый||
AGENT PAUSE CODES FOR THIS CAMPAIGN|КОДЫ ПАУЗ ОПЕРАТОРОВ ДЛЯ ДАННОЙ КАМПАНИИ||
TIME LIMIT|Лимит времени||
MGR APPROVAL|С подтверждением||
Mgr Approve|С подтверждением||
SYSTEM SETTINGS MODIFIED|СИСТЕМНЫЕ НАСТРОЙКИ ИЗМЕНЕНЫ||
Click here to see Admin changes to the system settings|Нажмите для просмотра изменений в системные настройки||
MUSIC-ON-HOLD(MOH) LISTINGS|СПИСОК КЛАССОВ МУЗЫКИ ПРИ УДЕРЖАНИИ||
Show MOH Entries|Показать классы MOH||
Add A New MOH Entry|Добавить новый класс MOH||
Show Email Accounts|Список Email аккаунтов||
Add A New Account|Добавить новый аккаунт||
Copy An Account|Скопировать аккаунт||
